button1,door1,,,,,,,,,
|w,w,w,w,w,w,w,w,w,w,w
w,f,f,f,f,f:bc,f,f:p2>n,f:bc,f,w
w,f,f:a^agent1,f,f:b^button2,f,f,f,f,f:b^button1,w
w,f,f,f,f,f,f,f,f,f,w
w,w,f:d>n^door1,w,w,f,f,f,f,f,f:d>w^door2
w,w,f:c,w,w,f,f,f,w,f,w
w,w,w,w,w,w,w,w,w,w,w
|w,w,w,w,w,w,w,w,w,w,w
w,,,,,,,,,,w
w,,,,,,,,,,w
w,,,,,,,,,,w
w,w,,w,w,,,,,,
w,w,,w,w,,,,w,,w
w,w,w,w,w,w,w,w,w,w,w