button0,,,,,,
|w,w,w,w,w,w,w
w,f:a^agent0,f,f,f:dhf,f,w
w,f,f,f,f:dhf,f,w
w,f,f,f,f:dhf,f,w
w,f,f,f,f:dhf,f:b^button0,w
w,f,f,f,f:dhf,f,w
w,f,f,f,f:dhf,f,w
w,f,f,f,f,f,w
w,f,f,f,f,f,w
w,w,w,w,w,w,w