w,w,w,w,w,w,w,w,w,w
w,f:a^agent0,f,f,f,f,f,f,f,w
w,f,w,w,w,w,w,w,f,w
w,f,w,,,,,w,f,w
w,f,w,,,,,w,f,w
w,f,w,,,,,w,f,w
w,f,w,,,,,w,f,w
w,f,w,w,w,w,w,w,f,w
w,f,f,f,f,f,f,f,f,w
w,w,w,w,w,w,w,w,w,w