button0,,,,,,,
|w,w,w,w,w,w,w,w
w,f,f,w,f,f,f,w
w,f,f:a^agent0,w,f,f:b^button0,f,w
w,f,f,w,f,f,f,w
w,f,f,f,f,f,f,w
w,w,w,w,w,w,w,w
|w,w,w,w,w,w,w,w
w,,,w,,,,w
w,,,w,,,,w
w,,,w,,,,w
w,,,,,,,w
w,w,w,w,w,w,w,w