button1,door1,,,,,,,,
|w,w,w,w,w,w,w,w,w,w
w,f:a^agent1,f,f,f,f,f,f,f,w
w,f,f,f,f,f,f,f,f,w
w,f,f,f,f,f,f,f,f,w
w,f,f,f,f,f,f,f,f,w
w,f,f,f,f,f:b>n^button1,f,f,f,w
w,f,f,f,f,f,f,f,f,w
w,f,f,f,f,f,f,f,f,w
w,f,f,f,f,f,f,f,f,w
w,w,w,f:d>n^door1,w,w,w,w,w,w
|w,w,w,w,w,w,w,w,w,w
w,,,,,,,,,w
w,,,,,,,,,w
w,,,,,,,,,w
w,,,,,,,,,w
w,,,,,,,,,w
w,,,,,,,,,w
w,,,,,,,,,w
w,,,,,,,,,w
w,w,w,,w,w,w,w,w,w
w,w,w,w,w,w,w,w,w,w
