button0,,,,,,
|w,w,w,w,w,w,w
w,f:a^agent0,f,w,f,f,w
w,f,f,w,f,f,w
w,f,f,w,f,f,w
w,f,f,w,f,f,w
w,f,f,w,f,f:b^button0,w
w,w,w,w,w,w,w
|w,w,w,w,w,w,w
w,,,,,,w
w,,,,,,w
w,,,,,,w
w,,,,,,w
w,,,,,,w
w,w,w,w,w,w,w