button0,,,,,,
|w,w,w,w,w,w,w
w,f:a^agent0,f,f:c>e,f,f,w
w,f,f,f:c>e,f,f,w
w,f,f,f:c>e,f,f,w
w,f,f,f:c>e,f,f,w
w,f,f,f:c>e,f,f:b^button0,w
w,w,w,w,w,w,w
|w,w,w,w,w,w,w
w,,,,,,w
w,,,,,,w
w,,,,,,w
w,,,,,,w
w,,,,,,w
w,w,w,w,w,w,w