button0,,,,,,
|w,w,w,w,w,w,w
w,f:a^agent0,f,f,f,f,w
w,f,f,f,f,f,w
w,f,f,f,f,f,w
w,f,f,f,f,f,w
w,f,f,f,f,f:b^button0,w
w,w,w,w,w,w,w
|w,w,w,w,w,w,w
w,,,,,,w
w,,,,,,w
w,,,,,,w
w,,,,,,w
w,,,,,,w
w,w,w,w,w,w,w