w,w,w,w,w
w,f:a^agent1,w,f,w
w,f,w,f,w
w,f,f,f,w
w,w,w,w,w
|w,w,w,w,w
w,,w,,w
w,,w,,w
w,,,,w
w,w,w,w,w