button0,door0,,,,,,,,,,
|w,w,w,w,w,w,w,w,w,w,w,w
w,f,f:t>n,f:c>s,f,f,w,f,f:npc^guard,f,f:dhf,w
w,f,f,f,f,f,w,f,f,f,f,w
w,f:p2>w,f,f:b^button0,f:a^agent0,f,f:d>w^door0,f:b^button1,f,f,f,w
w,f,f,f,f,f,w,f,f,f,f:g^FLAG,w
w,f:bc>e,f:t>n,f,f,f,w,f,f:a^BOSS,f,f:dhf,w
w,w,w,w,w,w,w,w,w,w,w,w
|w,w,w,w,w,w,w,w,w,w,w,w
w,,,,,,w,,,,,w
w,,,,,,w,,,,,w
w,,,,,,,,,,,w
w,,,,,,w,,,,,w
w,,,,,,w,,,,,w
w,w,w,w,w,w,w,w,w,w,w,w
|w,w,w,w,w,w,w,w,w,w,w,w
w,,,,,,w,,,,,w
w,,,,,,w,,,,,w
w,,,,,,w,,,,,w
w,,,,,,w,,,,,w
w,,,,,,w,,,,,w
w,w,w,w,w,w,w,w,w,w,w,w